20 20
####################
#....#.............#
#.@..#.............#
#....#.............#
##.###.............#
#....#.............#
#...c#.............#
#.####.............#
#...c#.............#
#c...#.............#
####.#.............#
#....#.............#
#.o..#.............#
#....#.............#
#....#.............#
#c.oc#...c.........#
#c.cc..cc..........#
#ccc....cc.........#
#kc.cc.c...........#
####################